OOOOOOOOOOOOOOOOOOOOOOOOOOOOOOO
OXO         O   O O O   O O   O
O O O OOOOO O OOO O OOO O OOO O
O   O O   O           O   O O O
OOOOO O O O O O OOO O O OOO O O
O O   O O O O O O O O     O   O
O OOO OOO O OOO O OOOOOOOOO OOO
O   O   O O O   O             O
O O O OOO O OOO O OOO OOO OOO O
O O   O   O O     O   O   O O O
OOOOO OOO OOOOOOOOO O O OOO OOO
O O         O   O O O O O O   O
O OOO OOO OOO O O OOOOO O O OOO
O O     O O O O               O
O OOOOOOOOO OOOOO OOO O OOO OOO
O   O     O   O O O   O   O   O
O O OOOOO OOO O O OOOOOOOOO OOO
O O   O       O         O   O O
O O OOO O OOOOO OOO OOOOO O O O
O O     O       O       O O   O
OOOOOOOOOOOOOOOOOOOOOOUOOOOOOOO