OOOOOOOOOOOOOOOOOOOOOOOOOOOOOOOOOOOOOOOOOOOOOOOOOOOOOOOOOOOOO
O       O         O           O         O   O O     O   O   O
OOO OOO OOO OOOOOOO O O O OOOOOOO OOO OOOOO O OOOOO OOO OOO O
O   O O   O   O     O O O O O       O       O O   O   O   O O
OOOOO O OOO OOOOO OOO O OOO OOOOOOO OOOOO OOO OOO O O O O O O
O   O O         O   O O   O             O O   O O   O   O  XO
OOO O O OOO OOO OOOOO O O O OOO OOOOO O OOO OOO O O O OOO OOO
O   O O O   O   O     O O O   O     O O   O O   O O O   O   O
OOO O OOOOO OOO O O O OOO OOOOO OOO OOOOOOO O O O OOOOOOOOOOO
O   O   O   O O   O O O O     O O     O O     O   O O     O O
O O OOO OOOOO O OOO OOO O OOOOOOO OOOOO O O OOOOOOO OOO O O O
O O O           O   O       O   O   O     O O O O O     O O O
O OOOOO OOOOOOOOOOOOO OOOOOOO OOOOO O O OOO O O O O O OOOOO O
O O       O   O O     O O O O O O   O O   O O       O   O   O
O O OOOOO O OOO O O OOO O O O O OOO OOOOO OOOOOOOOOOOOO OOO O
O     O       O   O O O O     O O O     O   O O     O   O   O
OOOOOOOOOOO OOO OOOOO O O OOO O O O OOOOO OOO O O O O OOOOO O
O           O O O       O   O   O   O       O   O O         O
U O OOO OOOOO OOO OOOOO OOOOOOO O O O OOO OOO OOOOOOO OOOOOOO
O O   O   O O O     O     O O     O   O   O     O   O       O
O OOOOOOO O O O OOOOOOOOO O OOOOO O OOO OOOOO OOO OOOOOOO O O
O O O O O O O       O       O O O O   O     O   O   O     O O
O O O O OOO OOO O O OOO OOOOO O O OOOOOOOOO OOO OOO OOOOO OOO
O         O   O O O   O       O       O     O   O     O     O
O O OOO O O OOO OOO OOOOOOOOO OOO O O OOO OOO OOOOO O OOO OOO
O O O   O       O   O     O       O O   O O   O   O O O     O
OOO O OOOOO O OOOOO O O O OOO O OOO O OOOOO OOOOO O OOO O OOO
O   O   O O O O       O O O O O   O O     O O O O   O   O   O
O OOOOOOO O OOO O O OOOOO O OOOOO OOOOO O O O O O O O O OOOOO
O   O       O   O O O     O       O     O         O O O     O
OOOOOOOOOOOOOOOOOOOOOOOOOOOOOOOOOOOOOOOOOOOOOOOOOOOOOOOOOOOOO