OOOOOOOOOOOOOOOOOOOOOOOOOOOOOOOOOOOOOOOOOOOOOOOOOOOOOOOOOOOOOOOOOOOOOOO
O O           O O         O     O O O   O   O     O O     O O   O O O O
O O OOOOO O OOO O OOOOOOOOOOO O O O OOO OOO OOO OOO O OOOOO O OOO O O O
O O O O O O       O     O O   O     O   O   O O       O O   O O O     O
O O O O O OOOOO OOO O OOO OOOOO O O O OOO O O O O O OOO OOO O O OOO OOO
O O O   O   O   O   O O   O     O O O O O O   O O O     O O O     O   O
O O O O OOOOOOO O OOOOO O O OOO OOO O O O OOO OOOOO OOO O O O O O O O O
O   O O   O             O   O   O   O O   O O O   O   O       O O   O O
OOOOO OOO OOOOOOOOOOOOOOO OOO O O OOO O O O OOOOO O O OOOOOOO OOO O OOO
O     O O       O     O O   O O O     O O   O       O   O       O O   O
OOO OOO O O O OOOOOOO O O OOOOOOOOO OOO OOO OOO O OOO OOOOOOOOO OOO OOO
O   O     O O   O         O O O       O O O     O O     O   O     O OXO
O OOOOO OOOOO O OOOOO OOO O O OOOOO OOO O OOOOO OOO OOOOO OOO O O OOO O
O   O       O O   O   O O         O           O   O O       O O O O   O
OOOOOOO O OOOOO O OOO O O OOO O OOOOOOO OOOOOOO OOOOOOO O OOO OOOOO OOO
O O   O O O O   O     O     O O O O O O   O   O O   O O O   O O O O   O
O O O O OOO OOO O OOOOOOO OOOOOOO O O O OOOOO O O O O O OOOOOOO O O O O
O   O   O   O O O   O   O O           O   O   O   O O O   O O       O O
O O O OOO OOO O OOO O OOOOO OOOOOOO OOOOOOO OOO O OOO O OOO OOOOOOOOO O
O O O O   O       O       O O         O O O O   O             O     O O
U OOOOOOO O OOOOOOOOOOO OOOOOOOOOOOOO O O O OOO OOO OOOOOOO OOOOO OOO O
O   O O       O   O O   O   O     O               O O   O   O   O O O O
OOOOO OOO O OOO OOO OOOOO O OOOOO OOOOO OOOOOOOOOOO OOO OOOOO OOO O O O
O   O     O O   O   O     O   O O         O   O   O   O     O   O     O
O OOO O OOO O OOOOO OOOOO OOO O O O OOO OOO OOOOO O OOO OOOOO OOOOO OOO
O O   O O               O O   O O O O   O     O     O O O   O O O   O O
O OOOOO OOOOOOO O O O OOOOOOO O OOO OOO O OOOOOOOOO O O OOO O O O OOO O
O O     O   O   O O O     O   O   O O         O O   O         O       O
O O OOO OOO OOO OOOOO OOOOOOO O OOO O OOOOOOO O OOO O OOOOOOO OOO OOOOO
O   O O     O       O O   O   O O   O   O     O O     O     O         O
O OOO OOO O OOO OOO O OOO OOO O OOO OOO OOOOO O O OOOOO O O O O O O OOO
O     O   O O   O O O O O O O O     O O   O O O     O   O O   O O O   O
O OOOOOOO O OOO O OOO O O O O OOOOOOO O OOO OOO OOO OOOOO O OOOOOOO OOO
O     O   O   O   O     O     O       O O O   O O   O O   O     O     O
O OOOOO OOO OOO O OOO OOO O OOOOO OOOOO O OOO O O OOO O OOOOO OOOOOOO O
O   O O O   O O O   O   O O       O O       O O O O       O   O     O O
OOOOO O OOO O OOO OOO OOOOO OOOOO O OOOOO OOO O O O OOOOO O O OOO OOO O
O       O   O       O       O         O     O   O O O     O O O       O
OOOOOOOOOOOOOOOOOOOOOOOOOOOOOOOOOOOOOOOOOOOOOOOOOOOOOOOOOOOOOOOOOOOOOOO