OOOOOOOOOOOOOOOOOOOOOOOOOOOOOOOOOOOOOOOOOOOOOOOOOOOOOOOOOOOOOOOOOOOOOOOOOUOOOOOOOOOOOOOOOOO
O O O O                 O   O O O   O O       O     O   O   O         O     O   O     O O O
O O O O OOO O OOO O O OOOOO O O O O O OOO OOO O O OOO O OOO OOOOOOO OOOOO OOO OOO OOOOO O O
O   O O   O O O   O O O   O       O O O     O   O O   O   O O     O     O   O O   O     O O
O OOO O OOO O OOO OOO OOO O OOOOOOO O O OOOOOOO OOO OOO O O O O OOO O OOO OOO O OOOOOOO O O
O         O O O     O     O O O O     O   O   O O     O O   O O     O   O         O O     O
O OOOOO O OOO OOO OOO OOOOO O O OOO OOOOOOOOO O OOOOOOOOOOO OOOOOOO OOO OOOOO OOOOO OOO OOO
O O     O   O O O O O     O   O     O             O       O           O O   O   O O       O
OOO O O O O O O OOO OOO O O OOOOO OOOOO OOOOOOOOOOO OOO OOO O O O OOO OOO OOO O O OOOOO OOO
O   O O O O O   O O   O O O O   O       O O   O O   O O O   O O O O       O   O O   O   O O
O O OOO O O OOOOO O OOO OOO O O O O OOO O OOO O O O O OOOOO O OOO OOOOOOO OOOOO OOO O O O O
O O   O O O O             O   O O O O   O   O     O     O   O O     O O O O           O   O
OOOOOOOOOOOOOOO O OOO O OOOOO OOO OOO O OOO OOOOOOOOO O OOO OOOOO OOO O OOOOOOOOOOOOOOO O O
O       O O   O O O O O       O     O O O     O       O O O     O       O       O   O   O O
O O O OOO O OOOOO O OOO OOOOO OOO O OOOOO O O O OOOOO OOO O OOOOOOOOO OOO OOOOO OOO O OOOOO
O O O     O           O     O O O O   O   O O O   O       O O       O O     O O           O
OOO OOO OOO OOOOOOO OOOOO OOOOO OOO OOO OOO OOOOO O O O OOOOO OOO O O OOO OOO OOOOOOOOO OOO
O O   O         O O O   O O     O     O O O O   O O O O   O O O O O O   O   O O   O   O   O
O OOO O O OOOOOOO OOO OOOOO O O OOOOOOO O O O O OOO OOOOO O O O O O OOO O OOO OOO OOO OOO O
O O   O O   O O     O   O   O O   O   O O O   O O     O O O   O O O O     O   O       O O O
O O O O OOO O O O OOO OOOOO O O O O O OOO O O OOOOOOOOO O OOO O OOO O O O OOO OOO OOO O O O
O   O O O     O O       O O O O O   O O   O O     O         O   O   O O O O     O O     O O
O OOO OOO OOOOOOO OOOOO O O O O OOOOO O O O OOO O OOO O O OOO OOO OOOOOOO O OOO OOO OOO O O
O O   O         O O O O   O O O     O   O     O O   O O O   O O           O   O       O O O
O OOOOOOO O O O O O O O OOOOOOOOO O OOOOO OOOOO OOO O O OOO OOOOOOO OOOOO O OOOOOOOOO O OOO
O O O   O O O O       O O O     O O O     O     O   O O O O             O O O       O O O O
O O O OOOOOOO OOO OOOOO O O OOOOOOOOOOO O OOOOOOO O O OOO O O OOO OOO O OOO OOOOO OOOOOOO O
O   O           O   O   O   O O   O     O O     O O       O O O   O   O     O       O     O
O OOO O O O OOOOOOOOOOO O O O O OOO OOO O O O OOOOO O OOOOO O O OOOOO OOO O OOO OOO O OOOOO
O   O O O O O     O   O   O O O     O   O O O   O O O O     O O O       O O       O O O   O
OOO O OOOOOOOOO O O O O O OOO OOOOO OOOOO OOOOO O OOO O OOOOO OOOOO OOOOOOOOOOOOO OOO O OOO
O   O   O   O   O   O   O     O O       O O         O O O O O O O O O       O       O   O O
OOOOOOOOO O OOO OOO O OOO OOO O O O O O OOO O O OOO OOOOO O O O O OOOOO OOO OOO O O OOO O O
O   O     O     O   O O O O   O   O O O   O O O O   O O     O   O O     O   O   O O   O   O
O OOOOO OOO OOOOOOO O O OOO OOOOOOOOOOO OOOOOOOOO OOO O OOOOOOO O OOOOOOOOO O OOOOOOO O OOO
O   O O   O   O   O O   O   O O     O   O O         O O         O   O     O O O           O
O OOO O OOOOO O O OOO OOO OOO O O OOOOO O OOOOOOOOO O O OOO OOOOO O OOO O O O OOO OOOOOOOOO
O   O       O   O   O O O O     O   O   O           O     O O O O O O   O   O O     O O O O
OOO O OOOOOOO OOOOO O O O O OOOOOOOOOOOOO OOOOO OOOOO O OOOOO O O OOO OOO OOO OOOOOOO O O O
O           O   O   O   O O         O     O     O     O O O O O     O   O O     O   O     O
O OOOOO OOO OOO O OOO O O O OOO OOOOOOOOO OOO OOOOOOO OOO O O OOO O OOOOO O OOO O OOO OOO O
O   O   O     O O O O O O   O O   O   O   O     O         O O   O O         O O O O   O O O
OOO O OOOOO OOOOO O OOOOOOOOO OOO OOO OOO O OOOOO OOO OOOOO O O OOO OOOOO O O OOO O OOO OOO
O   O     O O   O O           O       O   O   O O   O     O   O     O   O O O   O   O   O O
OOO O OOO OOO O O O OOOOO O O OOO OOO O OOOOOOO O O O OOOOO OOOOOOO O O OOOOOOO OOO O O O O
O O O O O O   O O O   O O O O O   O             O O O   O         O O O O O O         O O O
O OOO O OOO OOOOO O O O O OOOOO OOOOO O OOOOOOO O OOO OOOOO O O O OOO OOO O O OOOOO O OOO O
O   O       O   O   O O       O O     O       O   O O O   O O O O O O O   O   O O   O     O
O O O OOO OOO OOO OOO OOO OOO OOOOO OOO O OOOOOOO O O OOO OOOOO O O O OOO OOO O O OOOOO OOO
O O O   O   O       O O   O   O O     O O O   O   O   O       O O   O   O       O     O   O
OOO OOOOO OOOOOOOOOOOOO OOOOOOO OOOOO OOO OOO OOOOOOO O O OOOOOOOOO OOO OOOOO OOOOOOOOOOO O
O O   O O     O   O       O     O     O   O   O O O     O   O                 O   O O O   O
O OOO O OOO O OOO OOO O OOOOO OOO OOO OOOOO OOO O O OOOOOOOOOOO O OOOOOOOOO OOOOO O O OOOOO
O   O     O O O   O   O       O O O O   O   O     O     O O O O O     O O     O   O       O
O OOOOO OOOOOOOOO O OOO OOOOOOO O O OOO OOO OOO OOOOOOOOO O O OOOOO OOO OOOOO OOO OOOOOOO O
O           O   O     O O O   O     O   O     O O       O       O   O             O     O O
OOOOO O O OOO O OOO OOOOO OOO OOOOO O OOOOOOO O O O O OOO OOOOOOO OOOOOOO OOOOOOO O OOOOO O
O     O O   O O O     O O   O     O O     O   O   O O O       O         O O   O   O       O
O OOOOOOOOOOO O OOOOOOO O OOO OOO O O OOO OOO OOO OOO O OOOOO OOOOO O OOOOOOO OOOOO OOO OOO
O       O O O O O             O O   O   O O       O     O   O   O   O O O     O     O O   O
O OOO OOO O O OOOOOOOOOOO O OOO O OOO OOO O OOO O OOOOOOOOO OOO O OOO O OOOOO OOO O O O OOO
O O     O       O     O   O     O   O O       O O O     O   O   O O O O           O   O O O
OOOOOOO O O OOOOO O OOOOO OOO OOOOOOOOOOO OOOOO OOOOO O O OOOOOOOOO O O OOOOO O OOO OOOOO O
O     O O O O   O O       O   O   O   O O O     O     O O   O       O       O O O         O
OOO O O O OOO OOOOO O O OOOOO OOO OOO O OOOOOOO OOO OOO O OOO OOO OOOOOOO OOOOO O OOO OOO O
O O O           O   O O O     O       O   O     O O   O O     O   O       O     O O   O   O
O OOO OOOOOOO OOOOO OOOOOOOOOOOOOOO O OOO O OOO O O O OOOOO OOO O O O OOOOOOOOO OOOOOOOOO O
O O   O   O     O         O   O   O O     O O O O O O     O O   O   O       O   O O       O
O OOO O O O O OOOOOOO OOO O OOO OOO OOOOO O O O O OOOOO OOOOOOO OOOOO O OOO OOOOO OOOOO O O
O O   O O   O           O   O   O     O   O   O   O O O O O   O O   O O   O       O O   O O
O OOO OOOOOOOOO O OOOOO O OOOOO O OOOOOOOOOOO OOOOO O O O O OOOOO OOOOOOOOOOOOOOO O OOO OOO
O   O O O O   O O O O   O   O O   O O         O O O O O     O   O O O O O       O O       O
O O O O O O OOOOOOO OOO OOOOO OOO O OOOOOOOOOOO O O O O O OOO O O O O O O O O OOOOOOO O OOO
O O O     O       O O     O O   O O O O     O O       O O     O     O O   O O O O     O   O
OOO O OOOOO OOOOOOO OOO OOO OOO O O O OOOOO O OOO OOOOOOO O O OOOOO O OOOOOOO O OOO OOOOOOO
O O O     O O     O   O   O O     O   O O       O   O O   O O O       O   O           O   O
O O OOO O O OOOOO OOO OOOOO OOO OOO OOO O O OOO OOO O OOOOOOOOO O OOOOO O OOO OOOOO OOO O O
O   O   O           O O         O O       O   O                 O O     O   O   O O     O O
O OOOOO OOOOO OOO OOO OOO O O O O OOOOO OOOOOOOOOOOOO O OOOOO O O O O O O OOOOO O OOO OOOOO
O     O     O   O       O O O O       O   O     O     O O     O O   O O O O   O   O       O
OOOOO OOO O OOOOO O OOO O O OOO OOOOO O OOO OOO O O O OOOOOOOOO OOO O O O O O OOOOO O OOO O
O   O     O O     O O     O O     O O O     O   O O O O O     O O O O O O O O   O   O   O O
OOO O OOO OOOOO OOOOO O O OOOOOOOOO OOOOO OOOOO OOOOO O O OOO OOO O OOOOO OOOOO O O OOOOOOO
O   O   O O O     O   O O O   O         O   O O O O O   O O   O         O         O   O   O
O O OOO OOO O OOOOOOOOO OOOOO O OOO OOOOOOO O OOO O O O O O OOO O O O OOO O OOOOOOO OOO OOO
O O         O   O O   O   O O     O       O         O O   O O O O O O   O O   O O   O O O O
O O OOOOOOO OOO O O OOOOO O OOO O OOOOO O O OOO OOO OOOOOOOOO O O OOO O OOOOO O OOOOO O O O
O O O     O   O     O O O     O O O   O O   O O O   O     O O   O   O O O   O   O         O
O OOOOO O O O O O OOO O OOO OOO OOOOO OOOOO O OOOOOOO O OOO O OOOOOOO OOOOO O O O OOO OOOOO
O       O O O O O     O     O  X  O               O   O             O O       O   O       O
OOOOOOOOOOOOOOOOOOOOOOOOOOOOOOOOOOOOOOOOOOOOOOOOOOOOOOOOOOOOOOOOOOOOOOOOOOOOOOOOOOOOOOOOOOO