OOOOOOOOOOOOOOOOOOOOOOOOOOOOOOOOOOOOOOOOO
O     O   O         O   O     O         O
O O OOO OOO OOO O OOO OOO OOO O OOO OOOOO
OXO   O O O   O O O       O O   O       O
O OOO O O OOOOOOO O OOOOOOO O O OOOOOOOOO
O   O       O O     O   O     O   O   O O
O OOO OOOOO O OOO OOO OOOOOOOOO OOO OOO O
O O O O   O       O O O       O   O     O
O O OOO O OOO OOOOO O OOO O O O OOO O OOO
O       O   O           O O O       O   U
OOOOOOOOOOOOOOOOOOOOOOOOOOOOOOOOOOOOOOOOO