OOOOUOOOOOOOOOOOOOOOOOOOOOOOOOOOOOOOOOOOO
O O   O O     O   O         O         O O
O OOO O OOO OOOOO OOO O O OOOOOOOOO OOO O
O       O       O     O O     O     O   O
OOOOO OOO O O O O OOOOOOOOO OOO O OOOOO O
O         O O O           O     O O     O
OOO OOOOOOOOO OOOOO O OOOOO OOOOOOO OOOOO
O   O O O     O     O O O             O O
OOO O O O O O O O OOO O O OOOOOOOOOOO O O
O   O     O O O O   O   O   O        X  O
OOOOOOOOOOOOOOOOOOOOOOOOOOOOOOOOOOOOOOOOO