OOOOOOOOOOOOOOOOOOOOOOOOOOOOOOOOOOOOOOOOOOOOOOOOOOOOOOOOOOOOOOOOOOOOOOOOOOOOOOOOOOOOOOOOOOOOOOOOOOOOOOOOUOOOOOOOOOOOOOOOOOOOOOOOOOOOOOOOOOOOOOOOOOOOOOOOOOOOOOOOOOOOOOOOOOOOOOOOOOOOOOOOOOOOOOOOOOOOOOOOO
O   O O   O O O   O O O       O   O       O   O O     O   O       O O O     O O O   O     O O O           O O   O       O O           O       O   O O O     O     O O O   O   O   O           O O O O   O
OOO O OOO O O OOO O O O OOOOO O OOOOOOOOO OOO O OOO OOO O OOOOOOO O O O OOO O O O OOO OOO O O O OOOOOOO O O O OOO OOO OOO OOO OOOOOOOOO OOOOO O OOO O O OOO O OOOOO O OOO O O O O O OOO OOO OOO O O OOO O
O O O O   O   O O   O     O O O   O   O   O   O       O O O     O   O O O   O O       O   O O   O O O   O O O     O O   O       O O O O O           O     O O     O         O O O     O   O             O
O O O O OOO OOO OOO OOO OOO OOOOO O OOO O OOO OOO OOOOO O O O OOO OOO OOO OOO OOO OOOOOOO O OOOOO O OOO O O OOO OOO O OOOOO O OOO O O OOO O OOO OOOOOOO O O O OOOOO OOOOOOOOO O O OOO O O O OOOOO OOO O O
O     O               O O   O O   O   O O   O O   O     O   O     O O       O     O O O O   O O         O O       O       O O O   O O     O O O     O   O O     O       O O     O   O O O O     O O   O O
O OOO O OOO OOO OOOOO O OOO O O OOO OOO O OOO OOO OOOOO O OOO O O O OOO O OOOOO OOO O O OOO O O OOO OOOOO O OOO OOOOO OOO OOO O OOO OOOOOOO O OOO OOO OOO O OOO O O OOO O OOO OOOOO OOO OOOOOOOOOOOOO OOO
O O     O     O O         O O O   O O O O     O O   O   O   O O O       O O       O   O     O   O O   O     O   O     O     O     O   O O     O O   O O   O   O   O O O   O   O     O   O     O     O   O
OOO O O OOOOO OOO O O O OOO O O O O O O O OOOOO O O O OOO OOO O OOO OOOOO OOOOO OOO OOOOOOOOO OOO O O OOO OOO OOOOO OOOOOOOOOOOOO OOO O O OOO O OOO OOO O OOO OOOOOOO O O OOOOOOOOOOO OOO OOO O O OOO O O
O   O O O   O   O O O O     O   O O     O O       O O   O O   O O O O       O O   O     O     O     O O O O   O O O         O O         O O       O   O O   O O   O O   O O   O     O   O O   O O O   O O
OOOOOOOOO OOO OOO O OOO OOO O OOOOOOO OOOOO OOOOOOO OOOOOOOOO OOO O O OOOOO O O OOO OOOOO O OOOOO O OOO O OOOOO O O OOO O OOO OOO OOOOO OOO O OOOOO O OOO O OOO OOO O OOO O OOO OOOOOOO OOO OOO O O O OOO
O O       O O   O O   O   O                     O       O   O O     O O     O   O     O O O     O O O O O     O       O O   O O     O     O O   O O O O   O         O O           O O   O     O O O O   O
O OOO OOOOO O OOOOO OOOOOOOOO O O OOO OOOOOOO OOOOOOOOO O OOO OOOOOOOOOOO OOOOO O O OOO O OOOOOOO O O O O O O O OOOOO OOO OOO OOO OOOOOOOOOOOOOOO OOO O OOOOO OOO OOOOOOOOOOO O O O OOOOOOOOO OOO OOO O O
O O O         O       O     O O O O     O         O O   O               O   O   O O   O       O   O O     O O O     O O         O           O         O O   O O O     O O     O O O O     O     O O O O O
O O O OOO O O OOOOO O OOOOO O OOO O OOO OOO O OOOOO O O O OOOOOOOOO OOO OOOOO O O O O O OOOOOOO OOOOOOOOO O OOOOOOO OOOOOOOOO O OOOOO OOO O OOOOO OOO O OOO OOO OOO OOO O OOOOOOO O O O OOOOOOO O O OOO O
O O   O O O O   O O O O O O   O O O O   O O O O       O   O       O O   O O O O O O O O O O   O O O O     O O         O   O   O O       O O O       O     O O     O O     O O   O   O O O       O   O   O
O O OOO OOOOOOO O O OOO O O O O OOOOO O O O OOO OOO OOOOOOO O O OOO OOO O O O O O OOO OOO OOO OOO O O OOO OOOOO O OOOOO OOO OOO OOOOO OOOOO O OOO OOOOOOO O O OOOOOOOOOOO O O OOO OOO OOOOOOOOO O OOOOOOO
O O O O   O   O   O O O O   O O     O O   O O O O     O   O O O O   O O O   O O     O O   O O     O     O     O O   O   O   O     O   O   O O O   O     O O O   O     O     O   O   O   O               O
O O O OOO O OOO OOOOO O OOOOOOOOO OOO O OOO O OOO OOOOOOO O O OOO OOO OOO OOO O OOOOOOO O O OOOOO O OOO O OOOOOOO O OOO O O OOOOO O O O OOO OOO O O O OOO O O O O OOO O O OOOOO O O OOO OOO OOO OOO OOO O
O     O         O       O O O     O O O O O O     O       O O O O O           O   O O   O           O   O       O O O   O O   O O O O   O O O   O   O O O     O O O O   O O   O O O O     O O     O O O O
OOOOO O OOO OOO OOO O OOO O O OOOOO OOOOO OOOOOOO OOO OOOOO OOO O OOOOO OOOOOOOOOOO O OOOOOOOOO OOOOOOOOO OOO OOOOO OOO OOOOOOO OOO OOO O OOOOOOOOOOOOO OOOOO OOOOO OOO O O OOO O OOOOO OOO O OOO OOO OOO
O     O O     O O O O       O O O O     O O   O O O     O O O O           O   O       O O   O     O O   O   O O O O       O     O O O           O O O           O O     O   O   O O         O   O O O   O
OOO OOO O OOO OOO OOOOO O OOO O O O O OOO O O O O O O O O O O O OOOOO O O OOO OOOOOOOOO OOO O OOOOO O O O OOO O O OOOOO OOOOOOO O O O O OOO O OOO O OOO OOOOOOO O O O OOO O OOO O OOOOO OOOOO O OOO O O O
O O O   O O O         O O   O O   O O O O   O O O   O O   O         O O O       O       O   O O O   O O   O       O O     O O   O O O O   O O   O     O     O O O   O O O O O     O O   O     O O     O O
O OOOOOOOOO OOOOO O OOOOO O O OOO O OOO OOO OOO OOOOOOOOOOOOO OOOOO OOO O O OOO O OOOOO OOO O O O O OOOOOOO OOOOOOO O OOO O OOO O OOO OOO OOOOO OOO OOOOO OOO OOOOOOO O OOO OOOOO O OOOOOOOOO OOOOOOOOO O
O     O   O     O O       O     O O     O       O   O   O O     O O   O O O   O       O   O     O O   O   O   O   O     O             O   O     O O         O   O O O     O O       O     O O   O   O O O
OOO OOO O O OOOOO O OOOOOOOOOOOOO O OOOOOOOOOOO OOO O OOO O O OOO OOO O OOOOOOOOO OOOOOOO OOOOO O OOOOO OOOOOOOOO O OOO OOO OOOOOOO O O OOOOO OOO O O OOOOOOO OOO O OOO OOOOO OOO O O OOOOO O O OOO O O O
O       O   O   O O     O   O O O O   O O             O   O O O   O   O O     O O   O O     O   O   O O   O   O   O O   O   O O O   O O   O       O O             O   O O       O O           O       O O
O O OOOOO OOO O O OOOOO OOO O O O O OOO O OOO O O O OOO OOOOOOOOO OOO OOO O OOO OOOOO O O OOOOO O OOO OOO OOO O OOOOOOO O O O O OOOOOOOOO OOO O O O OOOOO OOOOOOO O OOOOO O OOOOOOO O OOO OOOOO OOOOOOO O
O O O         O O O                 O       O O O O O         O   O   O   O   O         O O       O     O       O   O   O O O     O   O   O O O O   O   O O O O         O O O O   O O O       O     O   O
O O OOO OOOOOOO O O OOO OOO O OOOOOOO OOOOOOOOOOOOO O OOOOO OOOOO OOO O OOO O O OOOOOOOOO OOOOO OOOOOOO O OOOOOOOOO OOOOO O O OOOOO OOO OOO O OOOOO O O OOO O OOOOOOO OOO O O O OOO O O O OOOOO O OOO OOO
O O O O       O O O O     O O     O           O O O       O O O       O O   O       O O O       O       O   O         O O O O   O O O     O   O       O O       O       O O O   O   O O O O O   O O O   O
OOO O OOOOOOOOOOO OOO OOOOO OOO O OOOOOOO OOOOO O OOO O OOO O O O OOO O OOO O O OOO O O O O OOO O OOOOO OOO O O OOO OOO O OOO OOO O O OOOOO OOOOO OOOOO OOO OOO OOOOO OOOOOOO O OOOOOOO O O OOO OOO OOO O
O O     O       O   O O   O O   O O         O         O O O     O   O O   O O O   O   O O O O O       O O   O O O O           O   O       O O       O     O O O O O O O O   O O     O   O O     O O O O O
O O OOOOO O O OOO OOO OOO O O O OOO O O OOOOO O O OOO OOO O O OOOOOOO O OOOOO OOOOOOOOO OOO O OOOOO OOOOOOO OOO O O OOOOOOO OOO OOOOOOO OOOOOOO O O OOOOO O O O O O OOO OOO OOOOO O O OOO OOO O O O O O O
O O   O   O O     O       O O O   O O O     O O O   O O     O O       O O   O O   O         O     O           O O O     O       O           O   O O   O       O O O     O O   O   O O O O O   O         O
O OOO OOOOO OOOOOOO OOO O OOO O OOO OOO OOO OOO O OOOOO OOOOO O OOO O OOOOO OOOOO OOO O OOO O OOO OOO O OOO OOOOO O OOOOO O OOO O O OOOOOOO OOOOOOO O O OOO O OOO O OOO O O OOO O OOO O OOOOO OOO OOO OOO
O O   O O O   O       O O   O O O   O O O   O   O     O   O   O   O O O           O   O   O     O O   O O       O   O     O O O O O O       O   O O O O   O O         O O   O   O   O O         O   O O O
O OOO O O O OOOOOOOOO OOOOO OOOOOOO O OOOOOOOOO O O O O O O O O O O OOO OOO OOOOO O OOO OOOOOOO OOO OOO O OOOOOOOOOOOOO OOOOO O OOOOOOOOO O OOO O OOOOOOO OOOOOOOOO OOOOO OOO OOOOO O O O OOO O O OOO O O
O                 OX      O       O   O         O O O O O O O O O O       O O     O O         O O   O   O             O     O         O   O           O       O           O     O     O O O   O O   O   O
OOOOOOOOOOOOOOOOOOOOOOOOOOOOOOOOOOOOOOOOOOOOOOOOOOOOOOOOOOOOOOOOOOOOOOOOOOOOOOOOOOOOOOOOOOOOOOOOOOOOOOOOOOOOOOOOOOOOOOOOOOOOOOOOOOOOOOOOOOOOOOOOOOOOOOOOOOOOOOOOOOOOOOOOOOOOOOOOOOOOOOOOOOOOOOOOOOOOOOOOO