####E############
#               #
##### ###########
#   # #         #
###   # ###### ##
#####P  #       #
############S####
